#000000#000000#000000#000000#000000#000000#000000#000000#000000#000000#000000#000000#000000#000000#000000#000000#000000#000000#000000#000000#000000#000000#000000#000000#000000#000000#000000#000000#000000
#000000#000000#000000#000000#000000#000000#000000#000000#000000#000000#000000#000000#000000#000000#000000#000000#000000#000000#000000#000000#000000#000000#000000#000000#000000#000000#000000#000000#000000
#000000#000000#000000#000000#000000#000000#000000#000000#000000#000000#000000#000000#000000#000000#000000#000000#000000#000000#000000#000000#000000#000000#000000#000000#000000#000000#000000#000000#000000
#000000#000000#000000#000000#000000#000000#000000#000000#000000#000000#000000#000000#000000#000000#000000#000000#000000#000000#000000#000000#000000#000000#000000#000000#000000#000000#000000#000000#000000
#000000#000000#000000#000000#000000#000000#000000#000000#000000#000000#000000#000000#000000#000000#000000#000000#000000#000000#000000#000000#000000#000000#000000#000000#000000#000000#000000#000000#000000
#000000#000000#000000#000000#000000#000000#000000#000000#000000#000000#000000#000000#000000#000000#000000#000000#000000#000000#000000#000000#000000#000000#000000#000000#000000#000000#000000#000000#000000
#000000#000000#000000#000000#000000#000000#000000#000000#000000#000000#000000#000000#000000#000000#000000#000000#000000#000000#000000#000000#000000#000000#000000#000000#000000#000000#000000#000000#000000
#000000#000000#000000#000000#000000#000000#000000#000000#000000#000000#000000#000000#000000#000000#000000#000000#000000#000000#000000#000000#000000#000000#000000#000000#000000#000000#000000#000000#000000
#000000#000000#000000#000000#000000#000000#000000#000000#000000#000000#000000#000000#000000#000000#000000#000000#000000#000000#000000#000000#000000#000000#000000#000000#000000#000000#000000#000000#000000
#000000#000000#000000#000000#000000#000000#000080#000000#000000#000000#000000#000080#000000#000000#000000#000000#000000#000000#000000#000000#000000#000000#000000#000000#000000#000000#000000#000000#000000
#000000#000000#000000#000000#000000#000000#000000#000000#000000#000000#000000#000000#000000#000000#000080#000000#000000#000000#000000#000000#000000#000000#000000#000000#000000#000000#000000#000000#000000
#000000#000000#000000#000000#000000#000000#000000#000000#000000#000000#000000#000000#000000#000000#000000#000000#000000#000000#000000#000000#000000#000000#000000#000000#000000#000000#000000#000000#000000
#000000#000000#000000#000000#000000#000000#000000#000000#000000#000000#000000#000000#000000#000000#000000#000000#000000#000000#000000#000000#000000#000000#000000#000000#000000#000000#000000#000000#000000
#000000#000000#000000#000000#000000#000000#000000#000000#000000#000000#000000#000000#000000#000000#000000#000000#000000#000000#000000#000000#000000#000000#000000#000000#000000#000000#000000#000000#000000
#000000#000000#000000#000000#000000#000000#000000#000000#000000#000000#000000#000000#000000#000000#000000#000000#000000#000000#000000#000000#000000#000000#000000#000000#000000#000000#000000#000000#000000
#000000#000000#000000#000000#000000#000000#000000#000000#000000#000000#000000#000000#000000#000000#000000#000080#000000#000000#000000#000000#000000#000000#000000#000000#000000#000000#000000#000000#000000
#000000#000000#000000#000000#000000#000000#000000#000000#000000#000000#000000#000000#000000#000000#000000#000000#000000#000000#000000#000000#000000#000000#000000#000000#000000#000000#000000#000000#000000
#000000#000000#000000#000000#000000#000000#000000#000000#000000#000000#000000#000000#000000#000000#000000#000000#000000#000000#000000#000000#000000#000000#000000#000000#000000#000000#000000#000000#000000
#000000#000000#000000#000000#000000#000000#000000#000000#000000#000000#000000#000000#000000#000000#000000#000000#000000#000000#000000#000000#000000#000000#000000#000000#000000#000000#000000#000000#000000
#000000#000000#000000#000000#000000#000000#000000#000000#000000#000000#000080#000000#000000#000000#000000#000000#000000#000000#000000#000000#000000#000000#000000#000000#000000#000000#000000#000000#000000
#000000#000000#000000#000000#000000#000000#000000#000000#000000#000000#000000#000000#000000#000000#000000#000000#000000#000000#000000#000000#000000#000000#000000#000000#000000#000000#000000#000000#000000
#000000#000000#000000#000000#000000#000000#000000#000000#000000#000000#000000#000000#000000#000000#000000#000000#000000#000000#000000#000000#000000#000000#000000#000000#000000#000000#000000#000000#000000
#000000#000000#000000#000000#000000#000000#000000#000000#000000#000000#000000#000000#000000#000000#000000#000000#000000#000000#000000#000000#000000#000000#000000#000000#000000#000000#000000#000000#000000
#000000#000000#000000#000000#000000#000000#000000#000000#000000#000000#000000#000000#000000#000000#000000#000000#000000#000000#000000#000000#000000#000000#000000#000000#000000#000000#000000#000000#000000
#000000#000000#000000#000000#000000#000000#000000#000000#000000#000000#000000#000000#000000#000000#000000#000000#000000#000000#000000#000000#000000#000000#000000#000000#000000#000000#000000#000000#000000
#000000#000000#000000#000000#000000#000000#000000#000000#000000#000000#000000#000000#000000#000000#000000#000000#000000#000000#000000#000000#000000#000000#000000#000000#000000#000000#000000#000000#000000
#000000#000000#000000#000000#000000#000000#000000#000000#000000#000000#000000#000000#000000#000000#000000#000000#000000#000000#000000#000000#000000#000000#000000#000000#000000#000000#000000#000000#000000
#000000#000000#000000#000000#000000#000000#000000#000000#000000#000000#000000#000000#000000#000000#000000#000000#000000#000000#000000#000000#000000#000000#000000#000000#000000#000000#000000#000000#000000
#000000#000000#000000#000000#000000#000000#000000#000000#000000#000000#000000#000000#000000#000000#000000#000000#000000#000000#000000#000000#000000#000000#000000#000000#000000#000000#000000#000000#000000
#000000#000000#000000#000000#000000#000000#000000#000000#000000#000000#000000#000000#000000#000000#000000#000000#000000#000000#000000#000000#000000#000000#000000#000000#000000#000000#000000#000000#000000
